10 66
################################################################
#...................#...#....#...............#.................#
#.......................#....#...............#..........<......#
#...................#...#....................#.................#
#...................#...#....#...............#########.#########
##############.######...#....#...............#.................#
#................>..#...#....#...............#.................#
#...................#...#....#...............#.................#
#...................#........#.................................#
################################################################
