#################################################################.
..................#...#....#...............#.................##...
....................#....#...............#..........<......##.....
..............#...#....................#.................##.......
............#...#....#...............#########.###################
####.######...#....#...............#.................##...........
.....>..#...#....#...............#.................##.............
......#...#....#...............#.................##...............
....#........#.................................###################
##################################################################
